00000000w00000000000000000000000000000000000000000000000000000000000000000000000000000000000000000000000000000000000000w00000000
00000000w00000000000000000000000000000000000000000000000000000000000000000000000000000000000000000000000000000000000000w00000000
00000000w00000000000000000000000000000000000000000000000000000000000000000000000000000000000000000000000000000000000000w00000000
00000000w00000000000000000000000000000000000000000000000000000000000000000000000000000000000000000000000000000000000000w00000000
00000000w00000000000000000000000000000000000000000000000000000000000000000000000000000000000000000000000000000000000000w00000000
00000000w00000000000000000000000000000000000000000000622250000000000000000000000000000000000000000000000000000000000000w00000000
00000000w00000000000000000000000000000000000000000000000000000000000000000000000000000000000000000000000000000000000000w00000000
00000000w00000000000000000000000000000000000000000000000000000000000000000000000000000000000000000000000000000000000000w00000000
00000000w00000000000000000000000000000000000062222222222222222222225000000000000000000000000000000000000000000000000000w00000000
00000000w000000000000000000000000000000000000b999999999999999999999a000000000000000000000000000000000000000000000000000w00000000
00000000w00000000000000000000000000000000000000000000000000000000000000000000000000000000000000000000000000000000000000w00000000
00000000w00000000000000000000000000006222500000000000000000000000000000000000000000006222250000000000000000000000000000w00000000
00000000w00000000000000000000000000000000000000622222222225000000000000000000000000000000000000000000000000000000000000w00000000
65000000w00000000000000000000000000000000000000811111111117000000000000000000062225000000000006222500000000000000000000w00000065
83250000w00000000000000000622222500000000000062411111111113250000000000000000000000000000000000000000000000000000000000w00006247
81132500w00000000000000000000000000000000000081111111111111170000000000000000000000000000000000000000000000000000000000w00624117
81111322222222222222500000000000000000062222241111111111111132222222222222222500000000000000000000062222222222222222222222411117
81111111111111111111700000000000000000081111111111111111111111111111111111111700000000000000000000081111111111111111111111111117
81111111111111111111322222222222222222241111111111111111111111111111111111111322222222222222222222241111111111111111111111111117
81111111111111111111111111111111111111111111111111111111111111111111111111111111111111111111111111111111111111111111111111111117
81111111111111111111111111111111111111111111111111111111111111111111111111111111111111111111111111111111111111111111111111111117
81111111111111111111111111111111111111111111111111111111111111111111111111111111111111111111111111111111111111111111111111111117
81111111111111111111111111111111111111111111111111111111111111111111111111111111111111111111111111111111111111111111111111111117
81111111111111111111111111111111111111111111111111111111111111111111111111111111111111111111111111111111111111111111111111111117
