00000000w00000000000000000000000000000000000000000000000000000000000000000000000000000000000000000000000000000000000000w00000000
00000000w00000000000000000000000000000000000000000000000000000000000000000000000000000000000000000000000000000000000000w00000000
00000000w00000000000000000000000000000000000000000000000000000000000000000000000000000000000000000000000000000000000000w00000000
00000000w00000000000000000000000000000000000000000000000000000000000000000000000000000000000000000622222222222222222225w00000000
00000000w00000000000000000000000000000000000000000000000000000000000000000000000000000000000000000811111111111111111117w00000000
00000000w00000000000000000000000000000000000000000000000000000000000000000000000000000000000000000b99999999999999999991w00000000
00000000w00000000000000000000000000000006222222222225000000000000000000000000000000000000000000000000000000000000000007w00000000
00000000w00000000000000000000000000000008111111111117000000000000000000000000000000000000000000000000000000000000000007w00000000
00000000w0000000000000000000622222500000b99999999999a000000000622222225000000000000000000000000000622222222222222222225w00000000
00000000w00000000000000000000000000000000000000000000000000000000000000000062222222225000000000000811111111111111111117w00000000
00000000w00000000000000000000000000000000000000000000000000000000000000000000000000000000000062222411111111111111111117w00000000
00000000w00000622222500000000000000000006222222222225000000000000000000000000000000000000000081111111111111111111111117w00000000
00000000w00000000000000000000000000000008111111111117000006222225000000000000000000622250000081111111111111111111111117w00000000
b2000000w000000000000000000000000000000081111111111170000000000000000000000000000000000000000b999999999999999999999999aw0000002a
52220000w00000000000000622222222225000008111111111117000000000000000000622222225000000000000000000000000000000000000000w00002226
5222220xw00000000000000811111111117000008111111111117000000000000000000811111117000000000000000000000000000000000000000wy0222116
52222222222222222222222411111111113222224111111111113222222222222222222411111113222222222222222222222222222222222222222222411116
51111111111111111111111111111111111111111111111111111111111111111111111111111111111111111111111111111111111111111111111111111116
51111111111111111111111111111111111111111111111111111111111111111111111111111111111111111111111111111111111111111111111111111116
51111111111111111111111111111111111111111111111111111111111111111111111111111111111111111111111111111111111111111111111111111116
51111111111111111111111111111111111111111111111111111111111111111111111111111111111111111111111111111111111111111111111111111116
51111111111111111111111111111111111111111111111111111111111111111111111111111111111111111111111111111111111111111111111111111116
51111111111111111111111111111111111111111111111111111111111111111111111111111111111111111111111111111111111111111111111111111116
51111111111111111111111111111111111111111111111111111111111111111111111111111111111111111111111111111111111111111111111111111116