0000000w0000000000000000000000000000000000000000000000000000000000000000000000000000000000000000000000000000000000000000w0000000
0000000w0000000000000000000000000000000000000000000000000000000000000000000000000000000000000000000000000000000000000000w0000000
0000000w0000000000000000000000000000000000000000000000000000000000000000000000000000000000000000000000000000000000000000w0000000
0000000w0000000000000000000000000000000000000000000000000000000000000000000000000000000000000000000000000000000000000000w0000000
0000000w0000000000000000000000000000000000000000000000000000000000000000000000000000000000000000000000000000000000000000w0000000
0000000w0000000000000000000000000000000000000000000000000000000000000000000000000000000000000000000000000000000000000000w0000000
0000000w0000000000000000000000000000000000000000000000000000000000000000000000000000000000000000000000000000000000000000w0000000
0000000w0000000000000000000000000000000000000000000000000000006222222222222222222222222500000000000000000000000000000000w0000000
0000000w0000000000000000000000000000000000000000000000000000008111111111111111111111111700000000000000000000000000000000w0000000
0000000w0000000000000000000000000000000000000000000000000622224111111111111111111111111322225000000000000000000000000000w0000000
0000000w0000000000000000000000000000000000000000000000000811111111111111111111111111111111117000000000000000000000000000w0000000
0000000w0000000000000000000000000000000000000000000062222411111111111111111111111111111111113222250000000000000000000000w0000000
0000000w0000000000006222222222222222222500000000000081111111111111111111111111111111111111111111170000000000000000000000w0000000
6500000w000000000000b999999999999999999a00000006222249999999999999999999999999999999999999999999932222500000000000000000w0000065
8325000w0000000000000000000000000000000000000000000000000000000000000000000000000000000000000000000000000000000000000000w0006247
8113250w0x000000000000000000000000000000000000000000000000000000000000000000000000000000000000000000000000000000000000z0w0624117
81111322222222222222500000000000000000062222222222222222222222222222222222222222222222222222222222222222222222222222222222411117
81111111111111111111322222222222222222241111111111111111111111111111111111111111111111111111111111111111111111111111111111111117
81111111111111111111111111111111111111111111111111111111111111111111111111111111111111111111111111111111111111111111111111111117
81111111111111111111111111111111111111111111111111111111111111111111111111111111111111111111111111111111111111111111111111111117
81111111111111111111111111111111111111111111111111111111111111111111111111111111111111111111111111111111111111111111111111111117
81111111111111111111111111111111111111111111111111111111111111111111111111111111111111111111111111111111111111111111111111111117
81111111111111111111111111111111111111111111111111111111111111111111111111111111111111111111111111111111111111111111111111111117
81111111111111111111111111111111111111111111111111111111111111111111111111111111111111111111111111111111111111111111111111111117
