00000000000000000000000000000000000000000000000000000000000000000000000000000000000000000000000000000000000000000000000000000000
00000000000000000000000000000000000000000000000000000000000000000000000000000000000000000000000000000000000000000000000000000000
00000000000000000000000000000000000000000000000000000000000000000000000000000000000000000000000000000000000000000000000000000000
00000000000000000000000000000000000000000000000000000000000000000000000000000000000000000000000000000000000000000000000000000000
00000000000000000000000000000000000000000000000000000000000000000000000000000000000000000000000000000000000000000000000000000000
00000000000000000000000000000000000000000000000000000000000000000000000000000000000000000000000000000000000000000000000000000000
00000000000000000000000000000000000000000000000000000000000000000000000000000000000000000000000000000000000000000000000000000000
00000000000000000000000000000000000000000000000000000000000000000000000000000000000000000000000000000000000000000000000000000000
00000000000000000000000000000000000000000000000000000000000000000000000000000000000000000000000000000000000000000000000000000000
00000000000000000000000000000000000000000000031111111111111111111112000000000000000000000000000000000000000000000000000000000000
00000000000000000000000000000000000000000000031111111111111111111112000000000000000000000000000000000000000000000000000000000000
00000000000000000000000000000000000000000000031111111111111111111112000000000000000000000000000000000000000000000000000000000000
00000000000000000000000000000000000000000000031111111111111111111112000000000000000000000000000000000000000000000000000000000000
00000000000000000000000000000000000000000000031111111111111111111112000000000000000000000000000000000000000000000000000000000000
00000000000000000000000000311111200000000000031111111111111111111112000000000000000000000000000000000000000000000000000000000000
00000000000000000000000000311111200000000000031111111111111111111112000000000000000000000000000000000000000000000000000000000000
00000000000000000000000000311111200000000000000000000000000000000000000000000000000000000000000000000000000000000000000000000000
00000000000000000000000000311111200000000000000000000000000000000000000000000000000000000000000000000000000000000000000000000000
00000000000000000000000000311111200000000000000000000000000000000000000000000000000000000000000000000000000000000000000000000000
00000000000000000000000000000000000000000000000000000000000000000000000000000000000000000000000000000000000000000000000000000000
00000000000000000000000000000000000000000000000000000000000000000000000000000000000000000000000000000000000000000000000000000000
00000000000000000000000000000000000000000000000000000000000000000000000000000000000000000000000000000000000000000000000000000000
00000000000000000000000000000000000000000000000000000000000000000000000000000000000000000000000000000000000000000000000000000000
00000000000000000000000000000000000000000000000000000000000000000000000000000000000000000000000000000000000000000000000000000000
