0000000w0000000000000000000000000000000000000000000000000000000000000000000000000000000000000000000000000000000000000000w0000000
0000000w0000000000000000000000000000000000000000000000000000000000000000000000000000000000000000000000000000000000000000w0000000
0000000w0000000000000000000000000000000000000000000000000000000000000000000000000000000000000000000000000000000000000000w0000000
0000000w0000000000000000000000000000000000000000000000000000000000000000000000000000000000000000000000000000000000000000w0000000
0000000w00000000000000000000000000000000000000000000000000000000000000000ecccd000000ecccccd00000000000000000000000000000w0000000
0000000w0000000000000000000000000000000000000000000000000000000000000000000000000000000000000000000000000000000000000000w0000000
0000000w0000000000000000000000000000000000000000000000062222222222250000000000000000000000000000000000000000000000000000w0000000
0000000w00000000000000000000000000000000000000000000622411111111111322500000000000000000000000ecccd000000000000000000000w0000000
0000000w0000000000000000000000000000000000000000062241111111111111111132500000000000000000000000000000000000000000000000w0000000
0000000w0000000000000000000000000000000000000062241111111111111111111111322500000000000000000000000000000000000000000000w0000000
0000000w0000000000000000000000000000000000622249999999999999999999999999999322250000000000000000000000ecccd0000000000000w0000000
0000000w0000000000000000000000000000000000000000000000000000000000000000000000000000000000000000000000000000000000000000w0000000
0000000w0000000000000000000000000000000000000000000000000000000000000000000000000000000000000000000000000000000000000000w0000000
6500000w000000ecccd00000000000000062222222250622222222225000006222222222222225062222222500000000000000000062222500000000w0000065
8325000w000000000000000000000062224999111117081111999999aecccdb999999111111117081111111322250000000000000081111700000000w0006247
8113250w0x0000000000000000622241a00000b9999a0b999a0000000000000000000b9999999a0b99999911111322250000000622411113225000y0w0624117
81111322222222222222222222411117000000000000000000000000000000000000000000000000000008111111111322222224111111111132222222411117
81111111111111111111111111111113222222222222222222222222222222222222222222225cd0000008111111111111111111111111111111111111111117
81111111111111111111111111111111111111111111111111111111111111111111111111117000000008111111111111111111111111111111111111111117
81111111111111111111111111111111111111111111111111111111111111111111111111113222222224111111111111111111111111111111111111111117
81111111111111111111111111111111111111111111111111111111111111111111111111111111111111111111111111111111111111111111111111111117
81111111111111111111111111111111111111111111111111111111111111111111111111111111111111111111111111111111111111111111111111111117
81111111111111111111111111111111111111111111111111111111111111111111111111111111111111111111111111111111111111111111111111111117
81111111111111111111111111111111111111111111111111111111111111111111111111111111111111111111111111111111111111111111111111111117
