00000000w00000000000000000000000000000000000000000000000000000000000000000000000000000000000000000000000000000000000000w00000000
00000000w00000000000000000000000000000000000000000000000000000000000000000000000000000000000000000000000000000000000000w00000000
00000000w00000000000000000000000000000000000000000000000000000000000000000000000000000000000000000000000000000000000000w00000000
00000000w00000000000000000000000000000000000000000000000000000000000000000000000000000000000000000000000000000000000000w00000000
00000000w00000000000000000000000000000000000000000000000000000000000000000000000000000000000000000000000000000000000000w00000000
00000000w00000000000000000000000000000000000000000000000000000000000000000000000000000000000000000000000000000000000000w00000000
00000000w00000000000000000000000000000000000000000000000000000000000000000000000000000000000000000000000000000000000000w00000000
00000000w00000000000000000000000000000000000000000000000000000000000000000000000000000000000000000000000000000000000000w00000000
00000000w00000000000000000000000000000000000000000000000000000000000000000000000000000000000000000000000000000000000000w00000000
00000000w00000000000000000000000000000000000000000000000000000000000000000000000000000000000000000000000000000000000000w00000000
00000000w00000000000000000000000000000000000000000000000000000000000000000000000000000000000000000000000000000000000000w00000000
00000000w00000000000000000000000000000000000000000000000000000000000000000000000000000000000000000000000000000000000000w00000000
00000000w00000000000000000000000000000000000000000000000000000000000000000000000000000000000000000000000000000000000000w00000000
b2000000w00000000000000000000000000000000000000000000000000000000000000000000000000000000000000000000000000000000000000w0000002a
52220000w00000000000000000000000000000000000000000000000000000000000000000000000000000000000000000000000000000000000000w00002226
52222200w00000000000000000000000000000000000000000000000000000000000000000000000000000000000000000000000000000000000000w00222116
52222222222222222222222222222222222222222222222222222222222222222222222222222222222222222222222222222222222222222222222222211116
51111111111111111111111111111111111111111111111111111111111111111111111111111111111111111111111111111111111111111111111111111116
51111111111111111111111111111111111111111111111111111111111111111111111111111111111111111111111111111111111111111111111111111116
51111111111111111111111111111111111111111111111111111111111111111111111111111111111111111111111111111111111111111111111111111116
51111111111111111111111111111111111111111111111111111111111111111111111111111111111111111111111111111111111111111111111111111116
51111111111111111111111111111111111111111111111111111111111111111111111111111111111111111111111111111111111111111111111111111116
51111111111111111111111111111111111111111111111111111111111111111111111111111111111111111111111111111111111111111111111111111116
51111111111111111111111111111111111111111111111111111111111111111111111111111111111111111111111111111111111111111111111111111116