00000000000000000000000000000000000000000000000000000000000000000000000000000000000000000000000000000000000000000000000000000000
00000000000000000000000000000000000000000000000000000000000000000000000000000000000000000000000000000000000000000000000000000000
00000000000000000000000000000000000000000000000000000000000000000000000000000000000000000000000000000000000000000000000000000000
00000000000000000000000000000000000000000000000000000000000000000000000000000000000000000000000000000000000000000000000000000000
00000000000000000000000000000000000000000000000000000000000000000000000000000000000000000000000000003111111111111110000000000000
00000000000000000000000000000000000000000000000000000000000000000000000000000000000000000000000000003111111111111110000000000000
00000000000311111111111111120000000000000000000000000000000000000000000000000000000000000000000000003111111111111110000000000000
00000000000311111111111111120000000000000000000000000000000000000000000000000000000000000000000000003111111111111110000000000000
00000000000311111111111111120000000000000000000000000000000000000000000000000000000000000000000000000000000000111110000000000000
00000000000311111111111111120000000000000000000000000000000000000000000000000000011111111111111111111111111111111110000000000000
00000000000311111111111111120000000000000000000000000000000000000000000000000000011111111111111111111111111111111110000000000000
00000000000311111111111111120000000000000000000000000000000000000000000000000000011111111111111111111111111111111110000000000000
00000000000311111111111111120000000000000000000000000000000000000000000000000000011111111111111111111111111111111110000000000000
00000000000311111111111111111111112000000000000000000000000000000000000000000031111111111111111111111111111111111110000000000000
00000000000031111111111111111111112000000000000000000000000000000000000000000031111111111111111111111111111111111110000000000000
00000000000031111111111111111111112000000000000000000000000000000000000000000031111111111111111111111111111110000000000000000000
00000000000031111111111111111111112000000000000000000000000000000000000000000000000000000000000000000000000000000000000000000000
00000000000000000000000000000000000000000000000000000000000000000000000000000000000000000000000000000000000000000000000000000000
00000000000000000000000000000000000000000000000000000000000000000000000000000000000000000000000000000000000000000000000000000000
00000000000000000000000000000000000000000000000000000000000000000000000000000000000000000000000000000000000000000000000000000000
00000000000000000000000000000000000000000000000000000000000000000000000000000000000000000000000000000000000000000000000000000000
00000000000000000000000000000000000000000000000000000000000000000000000000000000000000000000000000000000000000000000000000000000
00000000000000000000000000000000000000000000000000000000000000000000000000000000000000000000000000000000000000000000000000000000
00000000000000000000000000000000000000000000000000000000000000000000000000000000000000000000000000000000000000000000000000000000
