0000000w000000000000000000000000000000000000000000000000000000000000000000000000000000000000000000081111111111111111111111110000
0000000w000000000000000000000000000000000000000000000000000000000000000000000000000000000000000000081111111111111111111111110000
0000000w000000000000000000000000000000000000000000000000000000000000000000000000000000000000000000081111111111111111111111110000
0000000w000000000000000000000000000000000000000000000000000000000000000000000000000000000000000000081111111111111111111111110000
0000000w0000000000000000000000000000000000000000000000000000000000000000000000000000000000000000000b9999999999999911111111110000
0000000w000622222222222222222222250000625000000062222222222222225000000000000000000000000000000000000000000000000081111111110000
0000000w000811111199999999911111170000000000000000000000000000000000000000000000000000000000000000000000000000000081111111110000
0000000w000811111700000000081111170000000000000000000000000000000000000000000000000000000000000000062222222222500081111111110000
0000000w000811111700000000081111170000000062500000000000000000000000000000000000000000000000000000081111111111700081111111110000
0000000w000811111700000000081111170000000000000000000000000000000000000000000622222222222222222222249999999999a00081111111110000
0000000w000811111322250000081111170000000000000000000000000000000006222225000811111700000000000000000000000000000081111111110000
0000000w000811111700000000081111170000062222250000000000000000000000000000000811111700000000000000000000000062222241111111110000
0000000w000811111700000000081111170000000000000000000000000000000000000000000811111700000000000000000000000000000081111111110000
6500000w000b99999a00000006249999935000000000000000000000006222225000000000000b99999322222222222222222250000000000081111111110065
8325000w000000000000000000000000000000000000000000000000000000000000000000000000000000000000000000000000000000000081111111116247
8113250w000000000000000000000000000000000000000000000000000000000000000000000000000000000000000000000000000062222241111111624117
81111322222222222222222222222222222222222222222222222222222222222222222222222222222222222222222222222222222241111111111111411117
81111111111111111111111111111111111111111111111111111111111111111111111111111111111111111111111111111111111111111111111111111117
81111111111111111111111111111111111111111111111111111111111111111111111111111111111111111111111111111111111111111111111111111117
81111111111111111111111111111111111111111111111111111111111111111111111111111111111111111111111111111111111111111111111111111117
81111111111111111111111111111111111111111111111111111111111111111111111111111111111111111111111111111111111111111111111111111117
81111111111111111111111111111111111111111111111111111111111111111111111111111111111111111111111111111111111111111111111111111117
81111111111111111111111111111111111111111111111111111111111111111111111111111111111111111111111111111111111111111111111111111117
81111111111111111111111111111111111111111111111111111111111111111111111111111111111111111111111111111111111111111111111111111117
