0000000w0000000000000000000000000000000000000000000000000000000000000000000000000000000000000000000000000000000000000000w0000000
0000000w0000000000000000000000000000000000000000000000000000000000000000000000000000000000000000000000000000000000000000w0000000
0000000w0000000000000000000000000000000000000000000000000000000000000000000000000000000000000000000000000000000000000000w0000000
0000000w0000000000000000000000000000000000000000000000000000000000000000000000000000000000000000000000000000000000000000w0000000
0000000w0000000000000000000000000000000000000000000000000000000000000000000000000000000000000000000000000000000000000000w0000000
0000000w0000000000000000000000000000000000000000000006222500000000000000000000000000000000000000000000000000000000000000w0000000
0000000w0000000000000000000000000000000000000000000000000000000000000000000000000000000000000000000000000000000000000000w0000000
0000000w0000000000000000000000000000000000000000000000000000000000000000000000000000000000000000000000000000000000000000w0000000
0000000w0000000000000000000000000000000000000622222222222222222222250000000000000000000000000000000000000000000000000000w0000000
0000000w0000000000000000000000000000000000000b999999999999999999999a0000000000000000000000000000000000000000000000000000w0000000
0000000w0000000000000000000000000000000000000000000000000000000000000000000000000000000000000000000000000000000000000000w0000000
0000000w0000000000000000000000000000062225000000000000000000000000000000000000000000062222500000000000000000000000000000w0000000
0000000w0000000000000000000000000000000000000006222222222250000000000000000000000000000000000000000000000000000000000000w0000000
6500000w0000000000000000000000000000000000000008111111111170000000000000000000622250000000000062225000000000000000000000w0000065
8325000w0000000000000000006222225000000000000624111111111132500000000000000000000000000000000000000000000000000000000000w0006247
8113250w0x000000000000000000000000000000000008111111111111117000000000000000000000000000000000000000000000000000000000z0w0624117
81111322222222222222500000000000000000062222241111111111111132222222222222222500000000000000000000062222222222222222222222411117
81111111111111111111700000000000000000081111111111111111111111111111111111111700000000000000000000081111111111111111111111111117
81111111111111111111322222222222222222241111111111111111111111111111111111111322222222222222222222241111111111111111111111111117
81111111111111111111111111111111111111111111111111111111111111111111111111111111111111111111111111111111111111111111111111111117
81111111111111111111111111111111111111111111111111111111111111111111111111111111111111111111111111111111111111111111111111111117
81111111111111111111111111111111111111111111111111111111111111111111111111111111111111111111111111111111111111111111111111111117
81111111111111111111111111111111111111111111111111111111111111111111111111111111111111111111111111111111111111111111111111111117
81111111111111111111111111111111111111111111111111111111111111111111111111111111111111111111111111111111111111111111111111111117
